###############
# !           #
#0 0  !   0   #
#            0#
#!     !      #                
#    # #      #       
#    #0#B !   #         
#B   ###      #
#0         0  #   
#!   0    !   #   
#0     !      #
#  0       B  #           
###############